to understand - понимать
to happen - происходить
to travel - путешествовать
to answer - отвечать
to teach - учить
to write - писать
to check - проверять
to close - закрывать
to phone - звонить 
to speak - говорить
to sleep - спать
to stand - стоять
to help - помогать
to fall - падать
to hold - держать
to make - делать
to read - читать
to know - знать
to wash - мыть
to walk - ходить
to play - играть
to dust - убираться
to open - открывать
to take - брать
to rest - отдыхать
to work - работать
to live - жить
to like - любить
to look - смотреть
to ask - спрашивать
to say - сказать
to fly - летать
to eat - кушать
to use - использовать
to run - бежать
to go - идти
to do - делать